*******d*******
*****e*s*e*****
*e***e*e*e***e*
*e****e*e****e*
*e*****e*****e*
***************
*****ww*ww*****
d*************d
****wwwwwww****
***************
***************
***************
***************
***************
*******d*******