****w**d**w****
****w*****w****
****ww***ww****
*****w***w*****
www**w***w**www
**www*w*w*www**
*****w*e*w*****
d*****eee*****d
*****w*e*w*****
**www*w*w*www**
www**w***w**www
**h**w***w*****
****ww***ww****
****w*****w****
****w**d**w****