*******d*******
***************
***************
*******e*******
******e*e******
*****w*e*w*****
****w*e*e*w****
d**e*e*s*e*e**d
****w*e*e*w****
*****w*e*w*****
***************
***************
***************
***************
*******d*******