*******d*******
*************w*
************we*
*ew****w*e*****
*************e*
****e**********
*********e*****
d**wwe********d
***************
**e***w**ww****
*********e****e
*e*****hh******
**w********we**
*e*************
*******d*******