*******d*******
***************
***ww******ww**
***we*w**w*ew**
*****we**ew****
*****we**ew****
***w***ww***w**
d***w**ee**w**d
***w***ww***w**
*****we**ew****
*****we**ew****
***we*w**w*ew**
***ww******ww**
***************
*******d*******