*******d*******
*************we
e**w***********
*w*************
***e******w****
*****w*********
*w*************
d*************d
**w*****e******
**********w****
*******e*******
*****w*********
***********w***
*ew***********e
*******d**w****

