*******d*******
*****e*s*e*****
*q***e*e*e***q*
*e****e*e****e*
*q*****e*****q*
***************
*****ww*ww*****
d****w*l**w***d
****www*www****
***************
***************
***************
******sss******
***************
*******d*******