****w**d**w****
****weeeeew****
****weeeeew****
****weeeeew****
****w*****w****
****w*****w****
wwwww*****wwwww
d*ee*******ee*d
wwwww*****wwwww
****w*****w****
****w*****w****
****w*****w****
****w*****w****
****w*****w****
****w**d**w****