****w**d**w****
****weeew******
****weeeew*****
****weeeew*****
****w*****w****
****w*****w****
wwwww*****wwwww
d*ee*******ee*d
wwwww*****wwwww
****w*****w****
****w**g**w****
****w*****w****
****w*****w****
****w*****w****
****w**d**w****