*e**w**d**w**e*
e***w*****w***e
****w*****w****
***************
www*********www
***************
*******q*******
d******q******d
*******q*******
***************
www*********www
***************
****w*****w****
e***w*****w***e
*e**w**d**w**e*