*******d*******
***************
***************
***************
www*********www
**w*********w**
**w*********w*
d*we***e***e**d
**we***e***ew**
**w*eee*eee*w**
***w*e*e*e*w***
***ww*e*e*ww***
****w**e**w****
****w*****w****
*****w*d*w*****