*******d*******
***************
***************
***************
www*********www
**w*********w**
**w*********w*
d**e***s***e**d
**we***s***ew**
**w*eee*eee*w**
***w*e*s*e*w***
***ww*s*s*ww***
****w**s**w****
****w*****w****
*****w*d*w*****