*******d*******
****w*****wwe**
***ew**********
***ww*****ew***
***********w***
****w**********
****weew*******
d*************d
************w**
ww***ww****ew**
e**************
ww*w*******we**
**ew*******w***
***************
**eww**d*******