*******d*******
***************
****w**w**w****
****w*e*e*w****
*******w*******
*******w*******
****w*e*e*w****
d***w*e*e*w***d
*******w*******
*******w***h***
****w*e*e*w****
****w**w**w****
***************
***************
*******d*******