*******d*******
*************we
e**w***********
*w*************
***q******w****
*****w*********
*w*************
d*************d
**w*****q******
**********w****
*******q*******
*****w*********
***********w***
*ew***********e
*******d**w****

