*******d*******
***************
**ew*******we**
**we*******ew**
***************
*****we**ew****
*****e****e****
d******ee*****d
*****q****e****
*****wq**ew****
***************
**wq*******ew**
**qw*******we**
***************
*******d*******