*******d*******
***************
**ew*******we**
**we*******ew**
***************
*****we**ew****
*****e****e****
d******ee*****d
*****e****e****
*****we**ew****
***************
**we*******ew**
**ew*******we**
***************
*******d*******