*******d*******
***************
*******w*******
*****eewee*****
*******e*******
***************
***e*******e***
d*wwe**h**eww*d
***e***h***e***
***************
*******e*******
*******w*******
*******w*******
***************
*******d*******