*******d*******
***************
***ww******ww**
***we*w**w*ew**
*****we**sw****
*****we**sw****
***w***ww***w**
d***w**ee**w**d
***w***ww***w**
*****ws**ew****
*****wq**qw****
***ws*w**w*ew**
***ww******ww**
***************
*******d*******