*******d*******
****w*****wwe**
***ew**********
***ww*****ew***
***********w***
****w**********
****weew*******
d*************d
************w**
ww***ww****ew**
q**************
ww*w*******we**
**ew*******w***
*******g*******
**eww**d*******