*******d*******
***************
**e****w***e***
*e*e***w**e*e**
**e********e***
***************
*******ehhh****
d*ww**e*e**ww*d
*******e*******
*******g*******
**e********e***
*e*e***w**e*e**
**e****w***e***
***************
*******d*******