*******d*******
*****w*********
****ww***ww*****
***w***h***w***
***w*******w***
***we**e**ew***
wwww*e***e*wwww
d**e***e***e**d
wwww*e***e*wwww
***we**e**ew***
***w*******w***
***w***h***w***
****ww***ww****
*****w***w*****
*****w*d*w*****