*******d*******
*e************e
****e*****e****
***************
***e*******e***
***************
*******e*******
d*******h*****d
***************
****e**e*******
*********e*****
***s***********
*********h***s*
**s************
*******d******e