*******d*******
***************
***************
****e*****e****
***ew*****we***
*****we*ew*****
*****ewewe*****
d*****ewe*****d
*****ewewe*****
*****we*ew*****
***qw*****we***
****q*****e****
***************
***************
*******d*******