*e**w**d**w**e*
e***w*****w***e
****w*****w****
***************
www*********www
***************
*******e*******
d******e******d
*******e*******
***************
www*********www
***************
****w*****w****
e***w*****w***e
*e**w**d**w**e*