*******d*******
*****w*********
*f**ww***ww**i**
***w***h***w***
***w*******w***
***we**s**ew***
wwww*s***s*wwww
d**e***r***e**d
wwww*e***e*wwww
***we**s**ew***
***w*******w***
***w***h***w***
****ww***ww****
*****w***w*****
*****w*d*w*****